NO./textures/1.xpm


SO./textures/wood.xpm


WE./textures/t3.xpm

EA./textures/t4.xpm


S./textures/sprites/sprite1.xpm

C 225,30,0

F 220,100,0

11111111111111111111111111111
1S000000001100000000000000001
10110000000100000000000010001
10010000000000000000000010001
101100N0011100000000000010001
10000000001100000111011110001
11110111111111011100000010001
11110111111111011101010010001
11000000110101011100000010001
10000000000000001100000010001
10010000000000001101010010001
11000000110101011111011110001
11110111111101011111011110001
11111111111111111111111111111